L~~~~~~~~G
A~~ED~~~~~
A~~~D~H~~~
~~~~~~~~~~
~~C~~~~~~~
~~C~~F~~~B
~~~~~~~~~B
~~~~~~~K~~
~~~~~J~~M~
~~~I!~~~MM

~~~~~!~~~~
~~~~~~~~~~
~~~~~~~~~~
~~~~~~~~~~
~~~~~~~~~~
~~~~~~~~~~
~~~~~~~~~~
B~~~~~~~~~
B~~~~~~~M~
~~~~G~~~MM

~A~~~~
~~~~D!
~G~~D~
~~~~~~