L00000000G
A00ED00000
A000D0H000
0000000000
00C0000000
00C00F000B
000000000B
0000000K00
00000J00M0
000I*000MM

00000*0000
0000000000
0000000000
0000000000
0000000000
0000000000
0000000000
B000000000
B0000000M0
B000G000MM

0A0000
0000D*
0G00D0
0000D0