LL~~~~~~~G
LL~E~~~~~~
A~~~~~H~~~
~~~~~~~~~~
~~C~~~~~~~
~~C~~F~~~B
~~~~~~~~~B
~~~~~~~K~~
~~~IIJ~~~~
~!~II~~~~

~~~~~!~~~~
~~~~~~~~~~
~~~~~~~~~~
~~~~~~~~~~
~~~~~~~~~~
~~~~~~~~~~
~~~~~~~~~~
B~~~~~~~~~
B~~~~~~~M~
~~~~G~~~MM

~A~~~~
~~~~D!
~C~~D~
~~~~~!